1 0 1 1 1
1 4 1 3 2
1 0 3 4 1
1 1 4 1 1
1 1 1 1 1